12 10
. . . . . . . . . . . .
. # # # # # # # # # # .
. # # # . . # # # # # .
. # # # . B # # # . # .
. # # # . . . . B P # .
. # # # # . # . B . # .
. # . B . _ . . _ . # .
. # . _ . . _ . . . # .
. # # # # # # # # # # .
. . . . . . . . . . . .