15 8
. . . . . . . . . . . . . . .
. . # # # # # # # # # # # # .
. . # . _ . . . . . . . . # .
. . # . . . . B . . . . . # .
. # # . . . . B . . . . . # .
. # P . . . . . . . . _ . # .
. # # # # # # # # # # # # # .
. . . . . . . . . . . . . . .