15 9
. . . . . . . . . . . . . . .
. . # # # # # # # # # # # # .
. . # _ # . . . . . . . . # .
. . # . → . . B . . . . . # .
. . # ↑ . . . B B . . . . # .
. # # . . . . . . . . # # # .
. # P . . . . . . . . X _ # .
. # # # # # # # # # # # # # .
. . . . . . . . . . . . . . .