11 9
. . . . . . . . . . .
. . # # # # # # # . .
. . # # # P # . # . .
. . # # # B _ . # . .
. . # . B . . . # . .
. . # . _ . B _ # . .
. . # . . . . . # . .
. . # # # # # # # . .
. . . . . . . . . . .