15 8
. . . . . . . . . . . . . . .
. . # # # # # # # # # # # # .
. . # . _ . . . . . . . . # .
. . # . . . . B . . X . . # .
. # # . . . . B . . X . . # .
. # P . . . . . . . . _ . # .
. # # # # # # # # # # # # # .
. . . . . . . . . . . . . . .