10 9
. . . . . . . . . .
. . . # # # # # . .
. # # # . . . # . .
. # _ P B . . # . .
. # # # . B _ # . .
. # _ # # B . # . .
. # . # . _ . # # .
. # B . . B B _ # .
. # . . . _ . . # .
