13 9
. . . . . . . . . . . . .
. . . . . . . . . . . . .
. . # # # # # # # # # # .
. . # _ _ . . . . B _ # .
. . # . # . B . . B P # .
. . # # # . . . . # . # .
. . # # # # # # # # # # .
. . . . . . . . . . . . .
. . . . . . . . . . . . .
