15 7
. . . . . . . . . . . . . . .
. . # # # # # # # # # # # # .
. . # . _ . . . . B . . . # .
. . # . . . . # . . . . . # .
. # # . . . . # . B . . . # .
. # P . . . . # . . . _ . # .
. # # # # # # # # # # # # # .