15 8
. . . . . . . . . . . . . . .
. . # # # # # # # # # # # # .
. . # . . . . . . . . . . # .
. . # . . . . . . . . . . # .
. # # . . B . . . B . . . # .
. # P . . . . # . . . _ . # .
. # # # # # # # # # # # # # .
. . . . . . . . . . . . . . .