16 9
# # # # # # # # # # # # # # # #
# . . . → _ → . . . . . . . . #
# . . . # # # . . # # # . . . #
# . . . . # . . . # . # . . . #
# . . . # # # . . # # # . . . #
# . . . . . . . . . . . . . . #
# . . . . . . B B . . . . # # #
# P . . . . . . B . . . . X _ #
# # # # # # # # # # # # # # # #