12 7
. . . . . . . . . . . .
. # # # # # # # # # # .
. # _ _ . . . . B _ # .
. # . # . B . . B P # .
. # # # . . . . # . # .
. # # # # # # # # # # .
. . . . . . . . . . . .